                         Владимир Карлович МЮЛЛЕР

                          АНГЛО-РУССКИЙ СЛОВАРЬ


                            СПИСОК ЛИЧНЫХ ИМЕН


Abel - Эйбел, Абель
Abraham - Эйбрахам, Абрахам; Авраам
Ada - Ада
Adalbert - Адальберт
Adam - Адам
Adrian - Адриан
Agatha - Агата
Agnes - Агнесса
Alan - Алан
Albert - Альберт
Alec(k) - уменьш. от Alexander; Алек
Alexander - Александр
Alfred - Альфред
Algernon - Элджернон
Alice - Элис; Алиса
Allan - Аллан
Aloys - Алоиз
Amabel - Амабель
Ambrose - Эмброуз
Amelia - Амелия; Эмилия
Amy - Эми
Andrew - Эндрю
Andromache - Андромаxa
Andy - уменьш. от Andrew;Энди
Angelica - Анжелика
Angelina - Анджелина
Ann, Anna - Энн; Анна
Annabel - Эннабел, Аннабел
Annie - уменьш. от Ann, Anna; Энни
Anthony - Энтони; Антоний
Antoinette  - Антуанетта
Antony = Anthony
Arabella - Арабелла
Archibald - Арчибальд
Archie - уменьш. от Archibald; Арчи
Arnold - Арнольд
Arthur - Артур
Aubrey - Обри
August - Август
Augustus - Огастес; Август
Aurora - Аврора
Austin - Остин

Bab - уменьш. от Barbara; Бэб
Baldwin - Болдуин
Barbara - Барбара
Bart - уменьш. от Bartholomew; Барт
Bartholomew - Бартоломью; Варфоломей
Basil - Бэзил, Безил
Beatrice, Beatrix - Беатрис; Беатриса
Beck, Becky - уменьш. oт Rebecca; Бек, Бекки
Bel, Bella - умень. от Isabel, Isabella, Annabel и Arabella; Бел(л), Белла
Ben - уменьш. от  Benjamin; Бен
Benedict - Бенедикт
Benjamin - Бенджамин, Бенджамен; Вениамин
Benny - уменьш. от Benjamin; Бенни
Bernard - Бернард
Bert, Bertie - уменьш. от Albert, Bertram, Herbert и Robert; Берт, Берти
Bertram - Бертрам
Bess, Bessie, Bessy - уменьш. от Elisabeth; Бесс, Бесси
Betsey, Betsy - уменьш. от Elisabeth; Бетси
Betty - уменьш. от Elisabeth; Бетти
Вех - уменьш. от Rebecca; Бекс
Biddy - уменьш. от Bridget; Бидди
Bill, Billy - уменьш. от William; Билл, Билли
Blanch(e) - Бланш
Bod, Bobbie, Bobby - уменьш. от Robert; Боб, Бобби
Brian - Брайан; Бриан
Bridget - Бриджит, Бригитта

Candida - Кандида
Carol - Кэрол
Caroline - Кэролайн; Каролина
Carrie - уменьш. от Caroline; Кэрри
Caspar - Каспар
Catherine - Кэтрин; Екатерина
Саthiе - уменьш. от Catherine; Кэти
Cecil - Сесил
Cecilia, Cecily - Сесилия, Цецилия
Charles - Чарл(ь)з; Карл
Charley, Charlie - уменьш. от Charles; Чарли
Charlotte - Шарлотта
Chris - уменьш. от Christian, Christi(a)na, Christine и Christopher; Крис
Christian - Кристиан; Христиан
Christiana - Кристиана
Christie - уменьш. от Christian; Кристи
Christina, Christine - Кристина, Кристин
Christopher - Кристофер; Христофор
Christy = Christie
Clara - Клара
Clare - Клэр
Clarence - Клэренс, Кларенс
Claud(e) - Клод
Claudius - Клавдий
Clem - уменьш. от Clement; Клем
Clement - Клемент
Clementina, Clementine - Клементина
Clifford - Клиффорд
Clot(h)ilda - Клотильда
Colette - уменьш. от Nicola; Колетт(а)
Connie - уменьш. от Constance; Конни
Connor - Коннор
Constance - Констанс; Констанция
Cora - Кора
Cordelia - Корделия
Cornelia - Корнелия
Cornelius - Корнелий
Cyril - Сирил
Cyrus - Сайрус, Сайрес; ист. Кир

Dan - уменьш. от Daniel; Дэн, Дан
Daniel - Дэниел; библ. Даниил
Dannie - уменьш. от Daniel; Дэнни, Данни
Dave - уменьш. от David; Дейв
David - Дэвид; библ. Давид
Davy - уменьш. от David; Дэви
Deborah - Дебора
Den(n)is - Ден(н)ис
Desmond - Десмонд
Diana - Диана
Dick - уменьш. от Richard; Дик
Dickie - уменьш. от Richard; Дик(к)и
Dickon - уменьш. от Richard; Дикон
Dicky = Dickie
Dinah - Дина
Dob, Dobbin - уменьш. от Robert; Доб, Доббин
Doll, Dolly - уменьш. от Dorothy; Долл, Долли
Dolores - Долорес
Donald - Дональд
Dora - уменьш. от Theodora и Dorothy; Дора
Dorian - Дориан
Doris - Дорис
Dorothy - Дороти
Douglas - Дуглас

Ed - уменьш. от Edgar, Edmund, Edward и Edwin; Эд
Eddie, Eddy - уменьш. от Edward и Edwin; Эдди
Edgar - Эдгар
Edith - Эдит
Edmund - Эдмунд
Edna - Эдна
Edward - Эдвард; Эдуард
Edwin - Эдвин
Eleanor - Элинор; Элеонора
Elijah - Элайджа; библ. Илия
Elinor = Eleanor
Elisabeth, Elizabeth - Элизабет; Елизавета
Ella - уменьш. от Eleanor; Элла
Ellen - уменьш. от Eleanor, Эллен
Elliot - Эллиот
Elmer - Элмер
Elsie - уменьш. от Elisabeth и Alice; Элси
Elvira - Эльвира
Em - уменьш. от Emily; Эм
Emery - Эмери
Emilia - Эмилия
Emily - Эмили; Эмилия
Emm - уменьш. от Emma; Эм(м)
Emma - Эмма
Emmanuel - Эм(м)ануэль; Эммануил
Emmie - уменьш. от Emma; Эмми
Emory = Emery
Enoch - Инок; библ. Енох
Erasmus - Эразм
Ernest - Эрн(е)ст
Ernie - уменьш. от  Ernest; Эрни
Essie - уменьш. от Esther; Эсси
Esther - Эстер; библ. Эсфирь
Ethel - Этель
Etta - уменьш. от Henrietta; Этта
Eugene  - Юджин; Евгений
Eustace - Юстас
Eva, Eve - Ева
Evelina, Eveline, Evelyn - Эвелина, Эвелин

Fanny - уменьш. от Frances; Фанни
Felicia, Felice - Фелиция
Felix - Феликс
Ferdinand - Фердинанд
Fidelia - Фиделия
Flo - уменьш. от Florence и Flora; Фло
Flora - Флора
Florence - Флоренс
Flossie - уменьш. от Florence; Флосси
Floy - уменьш. от Florence; Флой
Frances - Франсис; Франcec; Франческа, Франциска
Francis - Франсис, Фрэнсис; Франциск; Франц
Frank - уменьш. от Francis; Фрэнк
Fred, Freddie, Freddy - уменьш. от Frederic(k); Фред, Фредди
Frederic(k) - Фредерик; Фридрих
Fr(i)eda - уменьш. от Winifred; Фрида

Gabriel - Габриель; библ. Гавриил
Geffrey, Geoffrey - Джеффри
George - Джордж, Георг
Gerald - Джеральд
Gertie - уменьш. от Gertrude; Герти
Gertrude - Гертруда
Gideon - Гидеон
Gil - уменьш. от Gilbert; Гил
Gilbert - Гил(ь)берт
Gladys - Глэдис
Gloria - Глория
Godfrey - Годфри
Godwin - Годвин
Gordon - Гордон
Grace - Грейс
Graham - Грейам, Грэхем
Gregory - Грегори
Greta - уменьш. от Margaret; Грета
Griffith - Гриффит
Guy - Гай
Gwendolen, Gwendoline, Gwendolyn - Гвендолин

Hadrian = Adrian
Hal - уменьш. от Henry; Хэл
Hannah = Anna
Harold - Гарольд
Harriet, Harriot - Харриет; Генриетта
Harry - Гарри
Hatty - уменьш. от Harriet, Harriot; Бэтти
Helen, Helena - Элен; Елена
Henrietta - Генриетта
Henry - Генри; Генрих
Herbert - Герберт
Herman(n) - Герман
Hester = Esther
Hetty - уменьш. от Henrietta и Hester; Хэтти, Хетти
Hilary - Хилари
Hilda - Хильда
Hope - Xoyп
Horace, Horatio - Горас, Горацио; Гораций
Howard - Говард
Hubert - Хьюберт
Hugh, Hugo - Хью, Хьюго
Humphr(e)y - Хамфри, Хэмфри, Гемфри

Ida - Ида
Ik, Ike - уменьш. от Isaac; Айк
Ira - Айра
Irene - Айрин, Ирэн; Ирина
Isaac - Айзек; Исаак
Isabel, Isabella - Изабелла
Isaiah - Исай(я)
Isidore - Исидор
Isold(e) - Изольда
Israel - Израиль

Jack - уменьш. от John; Джек
Jacob - Дже(й)коб; библ. Иаков
Jake - уменьш. от Jacob; Джейк
James - Дже(й)мс; библ. Иаков
Jane - Джейн
Janet - Дженет, Жанет
Jasper - Джаспер
Jean - Джин
Jeff - уменьш. от Jeffrey; Джефф
Jeffrey - Джеффри
Jem - уменьш. от James; Джем
Jemima - Джемайма
Jen, Jennie - уменьш. от Jane, Джен, Дженни
Jennifer - Дженифер
Jenny - уменьш. от Jane; Дженни
Jeremiah - Джереми; библ. Иеремия
Jerome - Джером
Jerry - Джерри
Jess - уменьш. от Jessica; Джесс
Jessica - Джессика
Jessie, Jessy - уменьш. от Janet, Jessica; Джесси
Jim, Jimmy - уменьш. от James; Джим, Джимми
Jo - уменьш. от Joseph и Josephine; Джо
Joachim - Иоахйм
Joan, Joanna - Джоан, Джоанна; - of Arc ист. Жанна д'Арк
Job - Джоб; библ. Йов
Jock - уменьш. от John; Джок
Joe - уменьш. от Joseph и Josephine; Джо
Joey - уменьш. от Joseph; Джо
John - Джон; Иоанн
Johnny - уменьш. от John, Джонни
Jonathan - Джонатан; библ. Ионафан
Joseph - Джозеф; Иосиф
Josephine - Джозефин; Жозефина
Joshua - Джошуа; библ. Иисус
Joy - Джой
Joyce - Джойс
Jozy - уменьш. от Josephine; Джози
Judith - Джудит; библ. Юдифь
Judy - уменьш. от Judith; Джуди
Julia - Джулия; Юлия
Julian - Джулиан; Юлиан
Juliana - Джулиана, Юлиана
Juliet - Джульетта
Julius - Джулиус; Юлий

Kate - уменьш. от Catherine; Keйт
Katharine = Catherine
Kathleen - Кэтлин
Katie = Cathie
Katrine - уменьш. от Catherine; Кэтрин
Keith - Кит
Kenneth - Кеннет
Kit - уменьш. от Christopher и Catherine; Кит
Kitty - уменьш. от Catherine; Китти

Lambert - Ламберт
Laura - Лора; Лаура
Laurence - Лоренс
Lauretta - уменьш. от Laura; Лоретта
Lawrence = Laurence
Lazarus - Лазарь
Leila - Лейла
Leo - Лео
Leonard - Леонард
Leonora - Леонора
Leopold - Леопольд
Lesley, Leslie - Лесли
Lew, Lewie - уменьш. от Lewis; Лу, Луи
Lewis - Льюис
Lillian - Лилиан; Лилиана
Lily - Лили
Linda - Линда
Lionel - Лайонел; Лионель
Liz, Liza, Lizzie - уменьш. от Elisabeth; Лиз, Лиза, Лиззи
Lola - уменьш. от Dolores; Лола
Lolly - уменьш. от Laura; Лолли
Lottie - уменьш. от Charlotte; Лотти
Louie - уменьш. от Louis; Луи
Louis - Луис, Луи
Louisa, Louise - Луиза
Lucas - Лукас
Lucy - Люси
Luke - Л(ь)юк; библ. Лука

Mabel - Мейбл
Madeleine - Маделейн; Маделина
Madge - уменьш. от Margaret; Мэдж, Мадж
Mag - уменьш. от Margaret; Мэг
Maggie - уменьш. от Margaret; Мэгти
Magnus - Магнус
Malcolm - Малькольм
Mamie - уменьш. от Mary; Мейми
Marcus - Маркус
Margaret - Маргарет; Маргарита
Margery - уменьш. от Margaret; Марджери
Margie - уменьш. от Margaret; Марджи
Maria - Мария
Marian - Мэриан
Marianne - Марианна
Marina - Марина
Marion - Марион, Мэрион
Marjory - уменьш. от Margaret; Марджори
Mark - Марк
Martha - Марта
Martin - Мартин
Mary - Мэри; Мария
Mat - уменьш. от Matthew, Matthias, Mat(h)ilda и Martha; Мэт
Mat(h)ilda - Матильда
Matthew, Matthias - Мэтью, Матиас; библ. Матфей
Matty - уменьш. от Martha и Mat(h)ilda; Мэтти
Maud(e) - уменьш. от Madeleine и Mat(h)ilda; Мод
Maurice - Морис
Max - уменьш. от Maxindlian; Макс
Maximilian - Максимилиан
May - уменьш. от Mary и Margaret; Мэй, Мей
Meg, Meggy - уменьш. от Margaret; Мэг, Мег, Мэгги, Мегги
Mercy - Мерси
Meredith - Мередит
Michael - Майкл; библ. Михайл
Micky - уменьш. от Michael; Мики
Mike - уменьш. от Michael; Майк
Mildred - Милдред
Millie - уменьш, от Mildred, Emilia и Amelia; Милли
Mima - уменьш. от Jemima; Майма
Minna - Минна
Minnie - уменьш. oт Minna; Минни
Mirabel - Мирабел(ь)
Miranda - Миранда
Miriam - Мириам
Moll, Molly - уменьш. от Mary; Молл, Молли
Monica - Моника
Montagu(e) - Монтегю
Monty - уменьш. от Montagu(e); Монти
Morgan - Морган
Morris - Моррис
Mortimer - Мортимер
Moses - Мозес; библ. Моисей
Muriel - Мюриель

Nance, Nancy - уменьш. от Agnes и Ann, Anna; Нэнс, Нэнси
Nannie, Nanny - уменьш. от Ann, Anna;  Нэнни
Nat - уменьш. от Nathaniel, Nathan  и Natalia, Natalie; Нат
Natalia, Natalie - Наталия,  Нэтали, Натали
Nathan - Натан
Nathaniel - Натаниэль
Ned, Neddie, Neddy - уменьш. от Edgar, Edmund, Edwin и Edward; Нед, Недди
Nell, Nellie, Nelly - уменьш. от Eleanor и Helen, Helena; Нел, Нелли
Net, Nettie, Netty - уменьш. от Antoinette, Henrietta и Janet; Нет, Нетти
Neville - Невиль
Nicholas - Николас; библ. Николай
Nik - уменьш. от Nicholas; Ник
Nikola - Никола
Nina, Ninette, Ninon - уменьш. от Ann, Anna; Hima, Нинетта, Нинон
Noah - Ной
Noel - Ноэль
Noll, Nolly - уменьш. от Olive, Olivia и Oliver; Нол, Нолли
Nora - уменьш. от Eleanor и Leonora; Нора
Norman - Норман

Odette - Одетта
Olive - Oлив, Оливия
Oliver - Оливер
Olivia - Оливия
Ophelia - Офелия
Oscar - Оскар
Osmond, Osmund - Ocмунд
Oswald - Освальд
Ottilia - Оттилия
Owen - Оуэн

Paddy - уменьш. от Patrick и Patricia; Пэдди, Падди
Pat - уменьш. от Patrick, Patricia и Martha; Пэт, Пат
Patricia - Патриция
Patrick - Патрик
Patty - уменьш. от Martha и Mat(h)ilda; Пэтти, Патти
Paul - Пол(ь); библ. Павел
Paula - Пола, Паула
Paulina, Pauline - Паулина; Полина
Peg, Peggy - уменьш. от Margaret; Пэг, Пег, Пэгги, Пегги
Pen - уменьш.  от  Penelope; Пен
Penelope - Пенелопа
Penny - уменьш. от Penelope; Пенни
Persy - Перси
Pete - уменьш. от Peter; Пит
Peter - Питер; библ. Петр
Phil - уменьш. oт Philip; Фил
Philip - Филип; Филипп
Pip - уменьш. от Philip, Пип
Pius - Пий
Pol, Polly - уменьш. от Mary; Полл, Полли
Portia - Порция

Rachel - Ре(й)чел; библ. Рахиль
Ralph - Ральф
Ranald - Рэнальд
Randolph - Рандольф
Raphael - Рафаэль
Rasmus - уменьш. от Erasmus; Расмус
Ray - уменьш. от Rachel и Raymond; Рей
Raymond - Раймонд
Rebecca - Ребекка; библ. Ревекка
Reg, Reggie - уменьш. от Reginald; Редж, Реджи
Reginald - Реджинальд
Reynold - Рейнольд
Richard - Ричард
Rita - уменьш. от Margaret; Рита
Rob, Robbie - уменьш. от Robert; Роб, Робби
Robert - Роберт
Robin - уменьш. от Robert; Робин
Roddy - уменьш. от Roderick; Родди
Roderick - Родерик
Rodney - Родни
Roger - Роджер
Roland - Роланд
Rolf - Рольф
Romeo - Ромео
Ronald - Рональд
Rosa - Роза
Rosabel, Rosabella - Розабел, Розабелла
Rosalia, Rosalie - Розалия, Розали
Rosalind, Rosaline - Розалина
Rosamond, Rosamund - Розамунда
Rose - Роуз; Роза
Rosemary - Розмари
Rowland = Roland
Roy - Рой
Rudolf, Rudolph - Рудольф
Rupert - Руперт
Ruth - Рут

Sadie - уменьш. от Sara(h); Сейди, Сэди
Sal, Sally - уменьш. от Sara(h); Сэл, Сэлли, Салли
Salome - Саломея
Sam, Sammy - уменьш. от Samuel; Сэм, Сэмми
Sam(p)son - Сэмпсон; библ. Самсон
Samuel - Сэмюел(ь); библ. Самуил
Sanders - уменьш. от Alexander; Сандерс
Sandy - уменьш. от Alexander; Сэнди, Санди
Sara(h) - Сара
Saul - Сол; библ. Саул
Sebastian - Себастиан
Septimus - Септимус
Sibil, Sibyl, Sibylla - Сибил, Сибилла
Sidney - Сидней
Siegfried - Зигфрид
Silas - Сайлас
Silvester - Сильвестр
Silvia - Сильвия; Сильва
Sim - уменьш. от Simeon и Simon; Сим
Simeon - Симеон
Simmy - уменьш. от Simeon и Simon; Симми
Simon - Саймон
Sol, Solly - уменьш. от Solomon; Сол, Солли
Solomon - Соломон
Sophia - София
Sophie, Sophy - уменьш. от Sophia; Софи
Stanislas, Stanislaus - Станислав
Stanley - Стэнли, Станли
Stella - Стелла
Stephana, Stephanie - Стефания
Stephen - Стив(е)н; Стефан
Steve - уменьш. от Stephen; Стив
Sue - уменьш. от Susan и Susanna(h); Сью
Susan - Сьюзен; Сюзанна
Susanna(h) - Сюзанна
Susie, Susy - уменьш. от Susan и Susanna(h); Сюзи
Sylvester = Silvester
Sylvia = Silvia

Ted, Teddy - уменьш. от Theodore; Тед, Тедди
Terry - уменьш. от T(h)eresa; Терри
Tessa - уменьш. от T(h)eresa; Тесса
Theobald - Теобальд
Theodora - Теодора
Theodore - Теодор
T(h)eresa - Тереза
Thomas - Томас; библ. Фома
Tib, Tibbie - уменьш. от Isabel, Isabella; Тиб, Тибби
Tilda - уменьш. от Mat(h)ilda; Тилда
Tilly - уменьш. от Mat(h)ilda; Тилли
Tim - уменьш. от Timothy; Тим
Timothy - Тимоти
Tina - уменьш. от Christina; Тина
Tobias - Тобайас, Тобайес
Toby - уменьш. от Tobias; Тоби
Tom - уменьш. от Thomas; Том
Tommy - уменьш. от Thomas; Томми
Tony - уменьш. от Anthony, Antony; Тони
Tristan - Тристан
Trudy - уменьш. от Gertrude; Труди
Tybalt - Тибальт

Valentine - Валентин
Veronica - Вероника
Victor - Виктор
Victoria - Виктория
Vincent - Винсент
Viola - Виола
Violet - Виолетта
Virginia - Вирджиния, Виргиния
Vivian, Vivien - Вивьен

Wallace - Уоллес, Уоллас
Walt - уменьш. от Walter; Уолт
Walter - Уолтер; Вальтер
Wat, Watty - уменьш. от Walter; Уот, Уотти
Wilfred, Wilfrid - Уилфред
Will - уменьш. от William; Уилл
William - Уильям, Вильям; Вильгельм
Willy - уменьш. от William; Уилли, Вилли
Win - уменьш. от Winifred; Уин
Winifred - Уинифред
Winnie - уменьш. от Winifred; Уинни


__________________________________________________________________________
     Текст подготовил Ершов В. Г. Дата последней редакции: 06/03/2000